{
    "width": 8,
    "height": 6,
    "tilewidth": 64,
    "tileheight": 64,
    "layers": [
        {
            "name": "tiles",
            "data": [
              2, 1, 2, 1, 0, 1, 2, 1, 
              2, 1, 2, 2, 1, 2, 1, 1, 
              2, 1, 1, 1, 1, 2, 1, 1, 
              2, 1, 2, 1, 2, 0, 2, 1, 
              2, 1, 2, 1, 1, 2, 1, 1, 
              2, 1, 0, 1, 0, 1, 1, 2
            ]
        }
    ]
  }