{
    "width": 8,
    "height": 6,
    "tilewidth": 64,
    "tileheight": 64,
    "layers": [
        {
            "name": "tiles",
            "data": [
              2, 1, 2, 1, 0, 1, 2, 1, 
              2, 1, 2, 2, 1, 2, 1, 1, 
              2, 1, 1, 1, 1, 2, 1, 1, 
              2, 1, 2, 1, 2, 0, 2, 1, 
              2, 1, 2, 1, 3, 3, 3, 3, 
              2, 1, 0, 1, 3, 3, 3, 3
            ]
        },
        {
            "name": "tiles2",
            "data": [
              1, 1, 2, 1, 2, 1, 2, 4, 
              1, 1, 2, 2, 8, 9, 10, 1, 
              1, 1, 1, 1, 38, 39, 40, 1, 
              1, 1, 2, 1, 68, 69, 70, 1, 
              1, 1, 2, 1, 98, 99, 100, 1, 
              1, 1, 0, 1, 0, 4, 4, 4
            ]
        }
    ]
  }