{
    "width": 8,
    "height": 6,
    "tilewidth": 128,
    "tileheight": 128,
    "layers": [
        {
            "name": "tiles",
            "data": [
                540, 541, 540, 541, 540, 541, 540, 541,
                570, 571, 570, 571, 570, 542, 632, 571,
                600, 600, 600, 601, 630, 602, 603, 571,
                540, 541, 540, 541, 540, 543, 543, 543,
                570, 571, 570, 571, 570, 572, 573, 574,
                570, 571, 570, 571, 570, 602, 603, 604
            ]
        }
    ]
  }