{
    "width": 8,
    "height": 6,
    "tilewidth": 32,
    "tileheight": 32,
    "layers": [
        {
            "name": "tiles",
            "data": [
                0, 0, 0, 0, 0, 0, 0, 0,
                0, 4, 0, 1, 8, 9, 10, 0,
                0, 1, 2, 2, 38, 39, 40, 0,
                0, 1, 2, 1, 68, 69, 70, 0,
                0, 1, 2, 1, 98, 99, 100, 0,
                0, 0, 0, 0, 0, 0, 0, 0
            ]
        }
    ]
  }