{
    "width": 8,
    "height": 6,
    "tilewidth": 32,
    "tileheight": 32,
    "layers": [
        {
            "name": "tiles",
            "data": [
                1, 2, 1, 2, 0, 2, 1, 2,
                1, 2, 1, 1, 2, 1, 2, 2,
                0, 1, 2, 2, 1, 1, 1, 1,
                1, 1, 2, 1, 2, 0, 1, 0,
                1, 1, 2, 1, 0, 1, 1, 1,
                0, 2, 1, 1, 1, 1, 2, 1
            ]
        }
    ]
  }