{
    "width": 8,
    "height": 6,
    "tilewidth": 192,
    "tileheight": 192,
    "layers": [
        {
            "name": "tiles",
            "data": [
              230, 201, 201, 201, 201, 201, 201, 260, 
              267, 382, 383, 384, 385, 382, 383, 266, 
              20, 293, 172, 20, 20, 20, 172, 20, 
              20, 293, 172, 20, 141, 141, 172, 20, 
              20, 293, 172, 20, 20, 20, 172, 20, 
              20, 81, 82, 83, 171, 171, 86, 87
            ]
        },
        {
            "name": "tiles2",
            "data": [
              299, 299, 299, 299, 299, 299, 299, 299, 
              299, 299, 299, 299, 800, 801, 802, 299, 
              299, 299, 299, 299, 830, 831, 832, 299, 
              299, 299, 299, 299, 860, 861, 862, 299, 
              299, 299, 299, 299, 890, 891, 892, 299, 
              299, 299, 299, 299, 299, 299, 299, 299
            ]
        }
    ]
  }